00100000100001000000000001010000
00000000000001000010010000000000
00100000000000100000000000000100
00000000000000000000000000001100
00100000000000100000000000001010
00000000000000000000000000001100
